1
Harrisonburg 50 30
1 8 32 35 12 15 18 3 37 4 15 7 3 16 10 40 20 38 15 15 23 15 25 12 6 12 24 9 11 1
30 24 8 30 5 12 18 0 10 7 9 11 18 39 40 35 36 25 26 4 17 33 37 24 7 21 28 10 2 16
21 0 38 10 16 12 3 32 7 37 3 2 30 1 35 0 33 1 23 0 7 40 6 8 7 19 26 29 24 5
19 28 35 3 6 32 20 13 9 31 14 18 18 18 38 15 18 32 25 10 38 0 11 10 39 29 40 16 25 14
19 26 24 18 24 31 14 32 34 38 37 37 27 40 23 37 4 19 24 33 22 29 24 2 26 5 15 18 1 14
22 36 11 19 1 37 26 11 6 12 25 39 36 26 19 28 40 3 2 20 17 31 2 28 36 12 11 34 27 25
32 18 5 19 8 27 4 38 1 1 3 7 3 38 26 6 14 27 30 36 30 29 37 38 18 25 8 34 2 1
10 39 2 25 29 12 24 3 36 38 34 14 15 25 8 11 0 17 22 17 33 27 36 39 20 19 37 12 34 40
35 9 21 1 25 29 21 20 33 2 22 14 2 10 36 33 11 38 29 37 38 32 1 0 38 18 0 18 26 40
10 10 1 27 5 40 10 20 22 17 32 28 2 4 3 30 38 39 33 33 30 2 23 14 13 28 18 40 36 10
6 21 17 2 22 34 25 9 14 29 15 16 28 27 17 24 16 25 1 8 8 25 5 2 36 8 14 16 7 17
28 31 9 37 23 37 31 30 0 10 7 1 8 3 8 19 4 1 3 26 7 6 36 22 25 15 16 40 25 32
27 14 0 20 10 20 22 34 11 26 24 2 28 15 19 32 9 34 0 20 10 31 32 2 2 33 22 29 7 1
15 11 40 34 2 16 21 38 3 3 0 27 15 29 18 37 2 21 20 37 35 12 5 2 37 30 10 15 10 16
9 1 27 17 31 5 6 30 9 3 24 20 0 22 23 28 22 13 38 3 25 2 34 30 28 27 28 19 21 29
6 30 34 36 28 15 25 37 38 27 24 10 0 23 40 16 27 9 14 28 29 16 32 8 29 21 32 16 2 16
16 26 12 35 23 1 31 36 37 15 15 8 33 2 40 12 16 26 36 18 17 3 20 28 0 3 36 1 36 34
29 7 11 37 12 34 4 16 16 6 10 21 29 10 28 2 30 38 11 40 21 22 39 15 33 38 31 30 39 12
5 27 27 31 18 20 14 17 34 36 17 33 20 9 14 26 19 21 37 25 15 25 32 38 36 27 34 0 8 4
14 35 4 3 40 13 25 33 12 12 37 31 22 0 36 37 7 4 6 40 24 30 4 22 20 37 13 24 23 1
24 13 16 20 36 40 6 17 28 37 33 10 33 13 27 21 39 32 7 7 9 2 31 23 15 37 36 23 28 6
33 15 38 37 24 28 14 38 8 1 40 19 22 36 12 3 11 10 39 6 40 27 36 32 8 23 22 22 4 38
14 28 9 22 28 20 17 9 4 7 19 31 31 7 35 37 38 5 11 21 10 9 32 39 35 30 28 13 33 6
33 24 27 22 35 39 14 1 25 3 32 30 13 3 10 6 11 1 11 37 15 18 3 40 10 20 36 8 34 5
29 4 20 12 20 29 36 35 33 13 18 3 40 7 33 8 16 13 24 3 14 20 4 30 33 20 40 40 32 20
17 24 6 37 28 33 7 18 23 31 27 32 11 36 18 40 15 11 24 12 34 17 30 24 23 5 17 4 23 10
30 24 28 24 28 26 24 37 2 11 0 10 32 19 18 17 33 33 32 12 1 5 35 22 39 3 9 37 16 13
31 7 1 23 9 16 9 24 5 23 29 2 17 40 32 23 29 19 22 37 7 18 32 34 12 27 14 29 39 17
22 19 29 39 8 7 16 40 18 13 32 33 8 31 15 18 33 7 30 10 2 24 9 38 31 28 6 27 17 10
38 31 4 16 9 7 34 25 5 40 5 4 1 0 9 17 38 29 15 38 22 26 36 25 29 25 26 7 13 38
36 23 22 32 13 40 29 25 26 20 2 25 25 32 21 0 17 8 28 21 33 20 3 12 40 4 17 25 9 20
16 33 25 18 33 38 13 35 40 17 7 35 0 29 28 19 7 7 7 34 27 40 15 28 35 30 16 17 11 7
13 38 20 34 21 21 36 17 32 2 38 22 1 6 10 23 17 30 5 16 1 4 22 39 3 0 38 17 33 25
23 1 0 14 24 3 37 36 35 31 34 26 21 11 30 33 22 5 30 9 35 4 38 19 37 29 31 17 37 39
4 10 23 10 27 0 39 6 4 18 15 25 12 27 17 39 33 34 17 30 36 34 18 2 34 20 0 38 13 40
35 15 33 22 0 23 39 20 25 5 36 24 11 8 36 18 9 15 33 38 39 33 35 27 2 1 33 16 15 5
33 11 7 35 24 28 1 39 30 21 10 15 32 15 0 20 10 24 36 38 19 27 36 28 21 16 12 33 27 38
14 38 29 36 14 19 24 22 38 2 38 12 6 18 10 34 19 35 13 38 24 39 27 25 3 15 30 22 25 39
10 40 13 0 15 18 19 22 27 2 15 39 27 36 37 11 38 2 12 26 2 13 13 40 26 16 8 15 17 26
21 12 6 17 22 37 36 5 16 27 38 13 33 28 9 33 2 40 8 12 15 14 2 23 26 25 20 1 9 40
15 30 24 28 32 9 27 11 16 16 31 25 38 24 12 5 24 33 5 10 19 0 20 37 28 18 38 40 17 23
33 27 27 7 31 3 6 34 22 40 11 24 16 28 31 37 9 5 26 19 25 23 13 29 27 39 31 9 0 12
7 34 15 11 29 14 37 28 8 22 34 36 30 30 0 12 24 26 2 35 21 16 2 5 25 23 25 33 21 8
38 2 40 0 17 10 20 31 18 22 15 12 13 2 15 5 5 29 28 5 35 36 33 16 37 6 7 25 27 35
8 2 31 24 32 28 19 14 40 22 3 36 5 34 8 38 28 38 25 38 37 12 6 27 38 31 16 23 12 23
32 30 23 11 5 0 3 2 15 36 23 11 30 12 3 23 0 22 15 24 28 40 39 27 27 2 4 26 2 33
31 20 9 6 17 0 15 32 15 20 32 8 14 39 14 27 17 29 21 7 27 29 29 8 8 7 3 7 19 4
4 19 5 14 11 23 39 22 19 27 34 23 0 30 34 9 10 30 11 29 37 13 31 32 12 16 8 34 36 40
12 30 9 10 27 0 38 13 14 35 37 39 34 39 17 17 29 9 40 30 6 13 19 25 3 23 16 27 12 8
26 32 39 7 12 3 25 37 1 14 30 14 22 4 26 19 26 2 40 28 37 25 3 7 3 9 31 3 25 31
